5 10
2333333332
2111211312
2113215412
2101111312
2333333332