8 10
2333333332
2111241112
2111231112
2011111012
2331111112
2111511312
2411211112
2333333332