10 11
23333333332
21012413112
21132124112
21131123112
21121111112
21111111232
21111111242
25111101112
21112111112
23333333332